.....,1......
....,2.2,..,,
...,33333,...
..,4..5..4...
....77777,,,,
...5..4..5..,
..6..555,.6.,
............,
...........,,
.............
............,
.............
.............
....,,,,,,,,,
