.............
88888......,,
11111........
22222,......,
33333.......,
66666.......,
55555 .....,,
44444.....,,,
33333....,.,,
.........999.
,,,,,,,,,9,,,
9999999999...
,............
....,,,,,,,,,
